9 10
..XK..XX..
XX...XGXX.
..XX....X.
.T..XX...X
X..X.....X
X..X...X..
X....K...X
X....XX..S
XX...XX...
