20 20
.....X.............T
.....X..............
.....X..............
.....X..............
.G...X......XXXXX...
.....X..............
.....X....XX........
...........X........
.K.........X.....K..
...........X........
....................
....................
...........XXXXXXXXX
....................
....................
XXXXXX............G.
....................
.........X....K.....
.........X..........
S........X..........
